_______________________________________________________________________________________________________________________________________*______________________________________________________________________________________________________________CCCC_______________________________________________________________________________________________________________________________________________________________________________________________________CCC_____________________W_______________CCCC_
__________________________________CCC_____________________________________________________________________________________CCCCC__________________Q_____________________________________________________________CCC__________________________________CCCCCCC___________________________________________CCC______________________________________________________________________________________________________________________________________________________CCCCCC___________________WWW_______________CC__
_________________________________CCCCCC_________________________________________________________________________________CCCCCCCC______________________________________________________________________________CCCCCC_________________________________CCCCC___________________________________________CCCCCC___________________________________________________________________________________________________CCC_________________________________________________CC_____________W_____WWWWW__________________
__________________________________CCCC____________________________________________________________________________________CCCC___________________OOO__________________CCC______________________________________CCCC____________________________________________________BBBB___________________________CCCC_____________________________________________XXXXX________________________________________________CCCCCC___BB_________________________________________________________WWW____OOOOO__________________
____________________________________________________________________CCCC___________________________________________________________________________________________CCCCCCC____________________________________________________________________________________________BBBBBBB_________________________________________________________________________________________________________________________________CC___BBBBBB______________________________________________________WWWWW___OOXOO__________________
_______________________________________________________BB_________CCCCCCC____________________________E_______________________________________________________________CCCC________________________________E___________________________________________________________BBBBBBBBBB___________________________________________________________________________________________________________________________________BBBBBBBB___________________O_O_O_O_O_O_O_O_O_O_O_O_O_O___W___OOOOO___OOOOO___O_O_O_O_O_O____
_______BBBB__________________________________________BBBBBB________CCCC___________________________________________________BBBB________________OO____________________________________________________________________BBBB_BBBB_________________________________________BBBBBBBB_________________________________________________________OOOOOOOOOO_______________________________X__________________________________BBBBBB____________________OOOOOOOOOOOOOOOOOOOOOOOOOOOO_WWW__OOXOO___OOOOO_OOOOOOOOOOOOO____
______BBBBBB_________________________*______________BBBBBBB_________________________________________OO___________________BBBBBB_________________________________________________________________________OOOOO______BBBBBBBBBBB__________________________________________BWBB_________________________________________________________OOOOWOWO*OOO_XXXXX_________________________X_____________________________________W______________________OOOWOWOWOWOWOWOWOWOWOWOWOWOOOOOOOOWOOOOWOWOOOOOWOWOWOWOWOWOWO____
_______BBB_________________________OOOO______________BBBBB_____________________________________O____XX____________________BBB______________________________________OOOOO_______________________OOOOO________________BBB*_BBB__________________E__________________________W________________________________________OOOOOOO___________OOOOOOOOOWOOO________________________OOO____X_____________________________________W______________________OOOWOWOWOWOWOWOWOWOWOWOWOWOOOOOOOOWOOOOWOWOOOOOWOWOWOWOWOWOWO____
________W_______________X__OOOO________________________W___________________________________________________________________W______________OOO________________________XXOOOO_____OOOOOOOOOO___________________________W____W_______________________________OOOO___________W____________________________OOO___________________________OOOOOWOWOWOOO_______________________________X_____________________________________W______________________WWOWOWOWOWOWOWOWOWOWOWOWOWOOOWWWOOWOOOOWOWOOOOOWOWOWOWOWOWOWO____
B_______W_______________X_____________________BB_______W__________________X_______________________________XXXXXXX__________W_____BB______________________E________X_______OXXXXXX____________________________________W____W_________BB_______OO__________OOOOOO__________W____B_____________________________________________________OOOOOOOOOWOOO______________OOOO_____________X_*_X__________________BB_____________W______________________WWOWOWOWOWOWOWOWOWOWOWOWOWOOOWWWOOWOOOOWOWOOOOOWOWOWOWOWOWOWO___B
BBB_____W___________________XXXXXXXX________BBBBB______W_________________XOX___XOX_______BB_____________BBB_*__XX__________W____BBBB____________X______BBB_______XXX_*____________________________________________XXXWXXXXWX_______BBBB____OOOOXXXXXXXXXXOOOOOOO_________W___BBB_____________________XXXXXXXXXXXXXXXXXXXXX__________WWWWWWWWWWWWW______X________________________X___X_________________BBBB____________W______________________@WOWOWOWOWOWOWOWOWOWOWOWOWOOOWWWOOWOOOOWOWOOOOOWOWOWOWOWOWOWO__BB
FFFFFFFFFFFFFFFFFFFFFFFFFFFFFFFFFFFFFFFFFFFFFFFFFFFFFFFFFFFFFFFFFFFFFFFFFFFFFFFFFFFFFFFFFFFFFFFFFFFFFFFFFFFFFFFFFFFFFFFFFFFFFFFFFFFFFFFFFFFFFFFFFFFFFFFFFFFFFFFFFFFFFFFFFFFFFFFFFFFFFFFFFFFFFFFFFFFFFFFFFFFFFFFFFFFFFFFFFFFFFFFFFFFFFFFFFFFFFFFFFFFFFFFFFFFFFFFFFFFFFFFFFFFFFFFFFFFFFFFFFFFFFFFFFFFFFFFFFFFFFFFFFFFFFFFFFFFFFFFFFFFFFFFFFFFFFFFFFFFFFFFFFFFFFFFFFFFFFFFFFFFFFFFFFFFFFFFFFFFFFFFFFFFFFFFFFFFFFFFFFFFFFFFFFFFFFFFFFFFFFFFFFFFFFFFFFFFFFFFFFFFFFFFFFFFFFFFFFFFFFFFFFFFFFFFFFFFFFFFFFFFFFFFFFFFFFF
TTTTTTTTTTTTTTTTTTTTTTTTTTTTTTTTTTTTTTTTTTTTTTTTTTTTTTTTTTTTTTTTTTTTTTTTTTTTTTTTTTTTTTTTTTTTTTTTTTTTTTTTTTTTTTTTTTTTTTTTTTTTTTTTTTTTTTTTTTTTTTTTTTTTTTTTTTTTTTTTTTTTTTTTTTTTTTTTTTTTTTTTTTTTTTTTTTTTTTTTTTTTTTTTTTTTTTTTTTTTTTTTTTTTTTTTTTTTTTTTTTTTTTTTTTTTTTTTTTTTTTTTTTTTTTTTTTTTTTTTTTTTTTTTTTTTTTTTTTTTTTTTTTTTTTTTTTTTTTTTTTTTTTTTTTTTTTTTTTTTTTTTTTTTTTTTTTTTTTTTTTTTTTTTTTTTTTTTTTTTTTTTTTTTTTTTTTTTTTTTTTTTTTTTTTTTTTTTTTTTTTTTTTTTTTTTTTTTTTTTTTTTTTTTTTTTTTTTTTTTTTTTTTTTTTTTTTTTTTTTTTTTTTTTTTTTTT
TTTTTTTTTTTTTTTTTTTTTTTTTTTTTTTTTTTTTTTTTTTTTTTTTTTTTTTTTTTTTTTTTTTTTTTTTTTTTTTTTTTTTTTTTTTTTTTTTTTTTTTTTTTTTTTTTTTTTTTTTTTTTTTTTTTTTTTTTTTTTTTTTTTTTTTTTTTTTTTTTTTTTTTTTTTTTTTTTTTTTTTTTTTTTTTTTTTTTTTTTTTTTTTTTTTTTTTTTTTTTTTTTTTTTTTTTTTTTTTTTTTTTTTTTTTTTTTTTTTTTTTTTTTTTTTTTTTTTTTTTTTTTTTTTTTTTTTTTTTTTTTTTTTTTTTTTTTTTTTTTTTTTTTTTTTTTTTTTTTTTTTTTTTTTTTTTTTTTTTTTTTTTTTTTTTTTTTTTTTTTTTTTTTTTTTTTTTTTTTTTTTTTTTTTTTTTTTTTTTTTTTTTTTTTTTTTTTTTTTTTTTTTTTTTTTTTTTTTTTTTTTTTTTTTTTTTTTTTTTTTTTTTTTTTTTTTT