_______________________________________________________________________________________________________________________________________*____________________________*__________________CCCCC_________________________________________________________________________________CCCCCCC___________________________________CCCCCC______________________________CCCCCC___________________________________________CCCCCCC______________________________________________________________________W_________________CCC
______________________________________________________________________________________________*___________________________CCCCC_________________________________________________________CC__________________________________________________________________________________CCCCCC___________________________________CCCCCCCCCC______________________________CCCCC_________________________________________CCCCCCCCC____________________________________________________________________WWW___________CCCCCCCC
________________________________________________________________________________________________________________________CCCCCCCC____________________________OOO_________________________________________________________BBBB______________CCC________________________________CCCC______________________________________________________________________________________________________________________________CCCC______________________________________________________________W_____WWWWW____________CCCCCC
__________________________________________________________________________________________________________________________CCCC________________X__OOO__________________CCC______________________________________________BBBBBB___________CCCCC_________________________________________________________________________________________________CCC___________________________________________________________________BBB_________________________________________________________WWW____OOOOO__________________
_____________________________________________________________________CCC____________________________________________________________________________________________CCCCCCC___________________________________________BBBBBB______________CC________________________________________________________________________________________________CCCCCC________________________________________________________________BBBBBBBB_____________________________________________________WWWWW___OOXOO__________________
___________________________________________________________________CCCCCC______________________________________________________________________________________________CCC___OOOOO_________________O_____XOX___________BBBBBB____________________________________________________________________________________*____________________________CC________________________________________________________________BBBBBBBBB____________________O_O_O_O_O_O_O_O_O_O_O_O_O_O___W___OOOOO___OOOOO___O_O_O_O_O_O____
_______BBBB_________________________________________________________CCC_____________________________________________BBBB_____________________O____________________________________________________________X______________W_______________________________________________________________________________OOO____BBBB_______________________________________________________________________________B_____________BBBBBBBB____________________OOOOOOOOOOOOOOOOOOOOOOOOOOOO_WWW__OOXOO___OOOOO_OOOOOOOOOOOOO____
______BBBBBB_______________________________X________________________________________________________OO_____________BBBBBB________________X________________________OOOOO_________________OOO__________X___________________W_____________________________________OOOO___O____O_____OO____________________________BBBBBB_____________________________________________________________________________BBBB____________B_W_BB_____________________OOOWOWOWOWOWOWOWOWOWOWOWOWOOOOOOOOWOOOOWOWOOOOOWOWOWOWOWOWOWO____
_______BBB_________________OOOO___________OOO___________XXXX__________________________________XOX___XX______________BBB_____________________________________________________________________________XOX_______X____X_____W____________________________________OO________________________________________________BBB__________________________________________________________O____________________BBBBB_____________W________________________OOOWOWOWOWOWOWOWOWOWOWOWOWOOOOOOOOWOOOOWOWOOOOOWOWOWOWOWOWOWO____
________W_________________OOOOO___________OOOO_________________________________________________X_____________________W__________________OOO_________________________________________________XXXWOOOOOOOOOOOOOOOOOOOOOXX_XW______________________________O____X______________________________________OOOXXXXXXXX__W_______OO______________________________OOOOW_______________X______________________W_______________W________________________WWOWOWOWOWOWOWOWOWOWOWOWOWOOOWWWOOWOOOOWOWOOOOOWOWOWOWOWOWOWO____
B_______W________________OOOOOO_____*_____OOOOO______X____________________X_______________________________XXXXXXX____W__________BB_____________________________________________________________WWWOOOOOOOOOOOOOOOOOOO__*XW______________________________________________________________OO_______________________W_______OOO_______OWOWOWO______________OOOOOW_______________X______________________W_______________W________________________WWOWOWOWOWOWOWOWOWOWOWOWOWOOOWWWOOWOOOOWOWOOOOOWOWOWOWOWOWOWO____
BBB_____W__BB___________OOOOOOOXXXXXOXXXXXOOOOOO____XXX_____X______@_____XOX___XOX_______________________O__*________W_________BBBB__________X________BBB______XXXX________XXXXXXXXXXXX________OOWWWWWWWWWWWWWWWWWWWW_BBBWB______________________BB________XXXXXXXXXXXXXXXXXXXXXXXXXXXXXXXXXXXXX_________________WXX_____OOOXXXXXXXXXXXXXXXXX__________OOOOOOXOXOXOXOXOXOXOXOX________BBB___________W_____BB________W________________________@WOWOWOWOWOWOWOWOWOWOWOWOWOOOWWWOOWOOOOWOWOOOOOWOWOWOWOWOWOWO____
FFFFFFFFFFFFFFFFFFFFFFFFFFFFFFFFFFFFFFFFFFFFFFFFFFFFFFFFFFFFFFFFFFFFFFFFFFFFFFFFFFFFFFFFFFFFFFFFFFFFFFFFFFFFFFFFFFFFFFFFFFFFFFFFFFFFFFFFFFFFFFFFFFFFFFFFFFFFFFFFFFFFFFFFFFFFFFFFFFFFFFFFFFFFFFFFFFFFFFFFFFFFFFFFFFFFFFFFFFFFFFFFFFFFFFFFFFFFFFFFFFFFFFFFFFFFFFFFFFFFFFFFFFFFFFFFFFFFFFFFFFFFFFFFFFFFFFFFFFFFFFFFFFFFFFFFFFFFFFFFFFFFFFFFFFFFFFFFFFFFFFFFFFFFFFFFFFFFFFFFFFFFFFFFFFFFFFFFFFFFFFFFFFFFFFFFFFFFFFFFFFFFFFFFFFFFFFFFFFFFFFFFFFFFFFFFFFFFFFFFFFFFFFFFFFFFFFFFFFFFFFFFFFFFFFFFFFFFFFFFFFFFFFFFFFFFFF
TTTTTTTTTTTTTTTTTTTTTTTTTTTTTTTTTTTTTTTTTTTTTTTTTTTTTTTTTTTTTTTTTTTTTTTTTTTTTTTTTTTTTTTTTTTTTTTTTTTTTTTTTTTTTTTTTTTTTTTTTTTTTTTTTTTTTTTTTTTTTTTTTTTTTTTTTTTTTTTTTTTTTTTTTTTTTTTTTTTTTTTTTTTTTTTTTTTTTTTTTTTTTTTTTTTTTTTTTTTTTTTTTTTTTTTTTTTTTTTTTTTTTTTTTTTTTTTTTTTTTTTTTTTTTTTTTTTTTTTTTTTTTTTTTTTTTTTTTTTTTTTTTTTTTTTTTTTTTTTTTTTTTTTTTTTTTTTTTTTTTTTTTTTTTTTTTTTTTTTTTTTTTTTTTTTTTTTTTTTTTTTTTTTTTTTTTTTTTTTTTTTTTTTTTTTTTTTTTTTTTTTTTTTTTTTTTTTTTTTTTTTTTTTTTTTTTTTTTTTTTTTTTTTTTTTTTTTTTTTTTTTTTTTTTTTTTT
TTTTTTTTTTTTTTTTTTTTTTTTTTTTTTTTTTTTTTTTTTTTTTTTTTTTTTTTTTTTTTTTTTTTTTTTTTTTTTTTTTTTTTTTTTTTTTTTTTTTTTTTTTTTTTTTTTTTTTTTTTTTTTTTTTTTTTTTTTTTTTTTTTTTTTTTTTTTTTTTTTTTTTTTTTTTTTTTTTTTTTTTTTTTTTTTTTTTTTTTTTTTTTTTTTTTTTTTTTTTTTTTTTTTTTTTTTTTTTTTTTTTTTTTTTTTTTTTTTTTTTTTTTTTTTTTTTTTTTTTTTTTTTTTTTTTTTTTTTTTTTTTTTTTTTTTTTTTTTTTTTTTTTTTTTTTTTTTTTTTTTTTTTTTTTTTTTTTTTTTTTTTTTTTTTTTTTTTTTTTTTTTTTTTTTTTTTTTTTTTTTTTTTTTTTTTTTTTTTTTTTTTTTTTTTTTTTTTTTTTTTTTTTTTTTTTTTTTTTTTTTTTTTTTTTTTTTTTTTTTTTTTTTTTTTTTTT