_________________________________________________________________________________________________________________________________________________________________________________________________________________________________________________________________________________________________________________OOOOOOWWWWW______________________________________________________________________________________________________________CC_____________________________________________W____________CCCCCCCC
_____________________CCC_________________________________________________CCC____________________________________________________________________________________________________________________________________________________________________________________________________________________________________OBBBBBBBBBBWW_____________________________________________________________________CCCCCCCCC_____________________________CCCCCCC_________________________________________WWW____________CCC____
__________________CCCCCCCC____________________________________________CCCCCCCC__________________________________________________________________________________________________________________________________________________________________________________________________________________________________O____WWWWWWWW_______________________________________________________________CCCCCCCCCCCCCCCC______________________________CCCC___________________________________W_____WWWWW__________________
______________________CCCCCCC_____________________________________________CC___________________________________________________CCCCCCCCCC______________________________B______CCCCCCC___________________________________________________________________________________________________________________________O____OOOO_______________________________________________________________________CCCCCCC_____________________________B___________________________________________WWW____OOOOO__________________
_______________________________________________________________*_____________________________________________________________CCCCCCCCCCCCCCC__________________________BBB__CCCCCCCCC_________________________________________________________________________________________________________OOOOOOOXXXXXOOOOOOO___OO______________________________________________________________________________________________________________BBB_________________________________________WWWWW___OOXOO__________________
___________________________________________________________OOOOOOOOO_____________________________________X__________________________________________________________BBBBOOB_X_______X___________________________________________________________________________________________________OOO________________________O_______________________________OOOO_______________________________________________________________O___________BBBBB______O_O_O_O_O_O_O_O_O_O_O_O_O_O___W___OOOOO___OOOOO___O_O_O_O_O_O____
_________________________________________________________________________________________________________X______________________CCC__________________________________BBBBB____________OO_X_________________________________________________________________________________________________OO_____________________OO__________________OOOO____________________________________________________________________________W__________BBBBBBB_____OOOOOOOOOOOOOOOOOOOOOOOOOOOO_WWW__OOXOO___OOOOO_OOOOOOOOOOOOO____
______________________________________________________O__________________________________________________X_____________________________________________________________W______________________________________________________________________________________________________________OOO_______OOOOO___OOOOOOOOOOO_O____________________________________________________________________________________OOW_________OO_________BBBBWBBBB____OOOWOWOWOWOWOWOWOWOWOWOWOWOOOOOOOOWOOOOWOWOOOOOWOWOWOWOWOWOWO____
_________________________________________________________________________OOOO_____________________OOO____X________*____________________________________________________O_________________________X__________XXXX_________________________________________________________________OOOOO__________O___O____OO________O__O__________________________________OOO_____________*________OOO_________________________________O_____________W________OOOWOWOWOWOWOWOWOWOWOWOWOWOOOOOOOOWOOOOWOWOOOOOWOWOWOWOWOWOWO____
__________________________________________OOOOOOO_________________________________OOO____________________X_______OOWO__________________________________________________O______XXX__________________X______________________________________BBBBBBBBBBBBBB_____________________OOOO_________OOWWWOO____O_____OOOOO____OO_________________________________________________OOOOO__________________OOW_____________________O_____________W_____*__WWOWOWOWOWOWOWOWOWOWOWOWOWOOOWWWOOWOOOOWOWOOOOOWOWOWOWOWOWOWO____
________________________________OOO__________________________________________________________OOO_________X___________________________________________OOWO______________O_XXX_____________*_____________________________XX_________________BBBBBBBBBOOWWOBB______________________________OO___________OOO_*_____O______________________________________________________________________________________________________O_____________W_____*__WWOWOWOWOWOWOWOWOWOWOWOWOWOOOWWWOOWOOOOWOWOOOOOWOWOWOWOWOWOWO____
__BBB________________OOO___XXXXXXXXXXXXXXXXXXXXXXXXXXXXXXXXXXXXXXXXXXXXXXXXXXXXXXXXXXXXOOO_______________X_XXXXXXXXXXXXXXXXXXXXXXX______OOO__________________________XXW_____XX__________________________X_____________________X_______OOXXXXXXXXXXXXXXXXXXXXXXXXXX_________________OOOOOOXXXXXXXX______OOOOOOOO________________________XXXXXXXXXXXXXXXXXXXXXXXXXXXXXXXXXXXXXXXXXXXXXXXXXXXXXXXXXXXXXXXXXXXXXXXXXXXXXXX_________BB__W________@WOWOWOWOWOWOWOWOWOWOWOWOWOOOWWWOOWOOOOWOWOOOOOWOWOWOWOWOWOWO____
FFFFFFFFFFFFFFFFFFFFFFFFFFFFFFFFFFFFFFFFFFFFFFFFFFFFFFFFFFFFFFFFFFFFFFFFFFFFFFFFFFFFFFFFFFFFFFFFFFFFFFFFFFFFFFFFFFFFFFFFFFFFFFFFFFFFFFFFFFFFFFFFFFFFFFFFFFFFFFFFFFFFFFFFFFFFFFFFFFFFFFFFFFFFFFFFFFFFFFFFFFFFFFFFFFFFFFFFFFFFFFFFFFFFFFFFFFFFFFFFFFFFFFFFFFFFFFFFFFFFFFFFFFFFFFFFFFFFFFFFFFFFFFFFFFFFFFFFFFFFFFFFFFFFFFFFFFFFFFFFFFFFFFFFFFFFFFFFFFFFFFFFFFFFFFFFFFFFFFFFFFFFFFFFFFFFFFFFFFFFFFFFFFFFFFFFFFFFFFFFFFFFFFFFFFFFFFFFFFFFFFFFFFFFFFFFFFFFFFFFFFFFFFFFFFFFFFFFFFFFFFFFFFFFFFFFFFFFFFFFFFFFFFFFFFFFFF
TTTTTTTTTTTTTTTTTTTTTTTTTTTTTTTTTTTTTTTTTTTTTTTTTTTTTTTTTTTTTTTTTTTTTTTTTTTTTTTTTTTTTTTTTTTTTTTTTTTTTTTTTTTTTTTTTTTTTTTTTTTTTTTTTTTTTTTTTTTTTTTTTTTTTTTTTTTTTTTTTTTTTTTTTTTTTTTTTTTTTTTTTTTTTTTTTTTTTTTTTTTTTTTTTTTTTTTTTTTTTTTTTTTTTTTTTTTTTTTTTTTTTTTTTTTTTTTTTTTTTTTTTTTTTTTTTTTTTTTTTTTTTTTTTTTTTTTTTTTTTTTTTTTTTTTTTTTTTTTTTTTTTTTTTTTTTTTTTTTTTTTTTTTTTTTTTTTTTTTTTTTTTTTTTTTTTTTTTTTTTTTTTTTTTTTTTTTTTTTTTTTTTTTTTTTTTTTTTTTTTTTTTTTTTTTTTTTTTTTTTTTTTTTTTTTTTTTTTTTTTTTTTTTTTTTTTTTTTTTTTTTTTTTTTTTTTT
TTTTTTTTTTTTTTTTTTTTTTTTTTTTTTTTTTTTTTTTTTTTTTTTTTTTTTTTTTTTTTTTTTTTTTTTTTTTTTTTTTTTTTTTTTTTTTTTTTTTTTTTTTTTTTTTTTTTTTTTTTTTTTTTTTTTTTTTTTTTTTTTTTTTTTTTTTTTTTTTTTTTTTTTTTTTTTTTTTTTTTTTTTTTTTTTTTTTTTTTTTTTTTTTTTTTTTTTTTTTTTTTTTTTTTTTTTTTTTTTTTTTTTTTTTTTTTTTTTTTTTTTTTTTTTTTTTTTTTTTTTTTTTTTTTTTTTTTTTTTTTTTTTTTTTTTTTTTTTTTTTTTTTTTTTTTTTTTTTTTTTTTTTTTTTTTTTTTTTTTTTTTTTTTTTTTTTTTTTTTTTTTTTTTTTTTTTTTTTTTTTTTTTTTTTTTTTTTTTTTTTTTTTTTTTTTTTTTTTTTTTTTTTTTTTTTTTTTTTTTTTTTTTTTTTTTTTTTTTTTTTTTTTTTTTTTTT